SO ./path_to_the_south_texture
EA ./path_to_the_east_texture
NO ./path_to_the_north_texture
WE ./path_to_the_west_texture
F 20,100,0
C 255,30,0



1111111111
1000000001
10000N0001
1000000001
1111111111
