SO ./path_to_the_south_texture
EA ./path_to_the_east_texture
NO ./path_to_the_north_texture
WE ./path_to_the_west_texture
F 20,100,0
C 255,30,0



        1111111111111111111111111
        1000000001100000000000001
        1011000001110000001110011
        10010000000000N0001 10001
111111111011000001110000001110001
100000000011000001110111111111111
11110111111111011100000010001
11110111111111011101010010001
11000000110101011100000010001
10000000000000001100000010001
10000000000000001101010010001
110000011111010111110111100111
11110111 1110101 101111010001
11111111 1111111 111111111111
