SO ./texture/wall_4.xpm
EA ./texture/wall_2.xpm
NO ./texture/wall_4.xpm
WE ./texture/wall_2.xpm
F  150,150,150
C  102,215,255




        1111111111111111111111111
        10000000011000000000000011111111111111111111111111111111111111111111111111111111111111111111111111111111111111111111111111111111111111
1111111110110000011100000011100111111111111111111111111111111111111111111111111111111111111111111111111111111111111111111111111111111111111111
1E00000000000000000000000010000000000000000000000000000000000000000000000000000000000000000000000000000000000000000000000000000000000000000001
1111111110110000011100000011100011111111111111111111111111111111111111111111111111111111111111111111111111111111111111111111111111111111111111
1000000000110000011101111111111111111111111111111111111111111111111111111111111111111111111111111111111111111111111111111111111111111111111111
11110111111111011100000010001
11110111111111011101010010001
11000000110101011100000010001
10000000000000001100000010001
10000000000000001101010010001
110000011111010111110111100111
11110111 1110101 101111010001
11111111 1111111 111111111111
